label count;predicted count;true predict;false predict;percent_true;percent_predict_true
77;119;58;61;75.32;48.74
82;45;25;20;30.49;55.56
82;152;56;96;68.29;36.84
107;99;55;44;51.4;55.56
79;56;32;24;40.51;57.14
65;85;42;43;64.62;49.41
70;94;43;51;61.43;45.74
110;82;53;29;48.18;64.63
62;67;24;43;38.71;35.82
86;49;31;18;36.05;63.27
