label count;predicted count;true predict;false predict;percent_true;percent_predict_true
68;69;40;29;58.82;57.97
80;93;54;39;67.5;58.06
69;110;41;69;59.42;37.27
99;172;76;96;76.77;44.19
65;74;41;33;63.08;55.41
61;67;40;27;65.57;59.7
67;63;37;26;55.22;58.73
100;111;69;42;69.0;62.16
64;23;15;8;23.44;65.22
74;26;12;14;16.22;46.15
