label count;predicted count;true predict;false predict;percent_true;percent_predict_true
77;118;59;59;76.62;50.0
82;46;26;20;31.71;56.52
82;159;59;100;71.95;37.11
107;92;52;40;48.6;56.52
79;54;29;25;36.71;53.7
65;87;42;45;64.62;48.28
70;89;39;50;55.71;43.82
110;87;54;33;49.09;62.07
62;65;26;39;41.94;40.0
86;51;35;16;40.7;68.63
