label count;predicted count;true predict;false predict;percent_true;percent_predict_true
68;112;51;61;75.0;45.54
80;50;26;24;32.5;52.0
69;175;50;125;72.46;28.57
99;107;48;59;48.48;44.86
65;50;19;31;29.23;38.0
61;91;40;51;65.57;43.96
67;85;38;47;56.72;44.71
100;89;52;37;52.0;58.43
64;29;16;13;25.0;55.17
74;20;7;13;9.46;35.0
