label count;predicted count;true predict;false predict;percent_true;percent_predict_true
77;80;49;31;63.64;61.25
82;84;53;31;64.63;63.1
82;86;41;45;50.0;47.67
107;165;89;76;83.18;53.94
79;76;50;26;63.29;65.79
65;65;41;24;63.08;63.08
70;55;34;21;48.57;61.82
110;121;82;39;74.55;67.77
62;40;20;20;32.26;50.0
86;76;54;22;62.79;71.05
