label count;predicted count;true predict;false predict;percent_true;percent_predict_true
77;79;50;29;64.94;63.29
82;85;55;30;67.07;64.71
82;94;46;48;56.1;48.94
107;157;86;71;80.37;54.78
79;77;51;26;64.56;66.23
65;64;41;23;63.08;64.06
70;57;38;19;54.29;66.67
110;119;84;35;76.36;70.59
62;35;20;15;32.26;57.14
86;81;57;24;66.28;70.37
